1111111111111
10010E000P001
1000011111C01
1000110000C01
1111111111111