1111111111111
10010E1100P01
1000011011C01
1000000000001
1111111111111