1111111111111
10011E1100P01
1000011011C01
1000110000C01
1111111111111