11111111111111111111111111111111111
1P0000000000000C00000C0000000010001
100000000000000C00000C0000000010C01
10100101001000001010010000000100001
10100100101010100010010000000101101
100000000C00C0000000000000000000E01
11111111111111111111111111111111111