1111111111111111111111111111111111
1E0000GGG0000G0C00000C000000G00001
10100101001000G0101001000000010101
1010010010101010001001000000010101
1P0000000C00C00000G0000G00000000C1
1111111111111111111111111111111111